levelNumber 7

P 3 2 1
P 6 3 4
P 10 2 6
P 16 3 4
P 20 4 4
P 24 3 4
P 30 2 1
M 0 33 1
P 45 2 4
P 55 3 4
P 66 1 2
P 75 2 2
P 85 3 4
P 90 1 2
P 100 2 1
