levelNumber 5

P 3 2 1
P 5 3 4
P 10 2 6
P 16 3 4
P 20 4 4
P 25 3 4
P 30 1 2
P 40 2 4
P 50 3 4
P 60 1 2
P 70 2 2
P 85 3 4
P 90 1 2
P 100 2 1
