levelNumber 6

-------------------------
                         |
                  0  ##  |
        0        ####    |
      ###                |
  ###    ###          ## |
    1        0      0    |
