levelNumber 8

P 3 2 1
P 6 3 4
P 10 2 6
P 16 3 4
P 20 4 4
P 24 3 4
P 30 2 1
M 0 33 1
P 45 2 4
P 50 3 4
P 54 1 2
P 60 2 2
P 65 3 4
P 70 1 2
P 75 2 1
P 82 3 4
P 86 4 6
P 92 2 1
P 96 2 4
P 100 4 1
